****************    ******
*______________*    *+M+$*
*_~_________~~~*    *++++*
*_~_________~@_******++++*
*_~____________P!++++++++*
*_~__________@__!++++++++*
*_~_________~__******++++*
*_~_________~~~*    ******
*______________*
*___@____@_____*
******__********
     *__*
     *--*
    **--**
    *----*
    *----*
    *----*
    *-|--*
	******
//////////////////////////
//А тут можно пихать скрипты
