***************************
*..._____________*+++++++$*
*...______P______!++++++++*
*..._____^^^^^^^^^+++++++M*
*_______^^^^^^^^^*++++++++*
***____********************
*___@____________*
*___________.____*
*________________*
*____.___________*
*________@_______*
*________________*
*________________*
*^^^^^__^^^^^^^^^*
*^^^^^__^^^^^^^^^*
*^^^^^__^^^^^^^^^*
*________________*
*_____@__________*
*_________.______*
***____***********
*~*__@_*~~~~~~~~~*
*~*____*~~~~~~~~~*
*________________*
*_______@________*
*-----------...--*
*----@------...--*
*-----------...--*
*--------|-------*
******************