****************    ******
*_____*________*    *+M+$*
*_~__~*_____~~~*    *++++*
*_~__~***___~@_******++++*
*_~__~*________P!++++++++*
*_~__~___________++++++++*
*___________~@_******++++*
*___________~~~*    ******
*______________*
*___@____@_____*
******__*****__*
     *__*   *__*
     *--*   *__*
    **--**  *__*
    *----*  *__****** ****
    *----*  *_______* *__*
    *----*  *_______* *__*
    *-|--*  ******__* ****
    ******       *__*
                 *__*****
                 *______*
                 *______*
