****************    *******
*_____@__@_____*    *+M+$+*
*~~~________~~~*    *+++++*
*~~~__...___~~~******+++++*
*_____...______P!+++++++++*
*_____...______@_+++++++++*
*^^^__^^^^^^^^^******+++++*
*^^^__^^^^^^^^^*    *******
*__@__@____.___*
*______________*
*~~~~~~~~__~~~~*
*~~~~~~~~__~~~~*
*______._______*
*___@____@_____*
*****----*******
    *----*
    **--**
    **--**
    **--**
    **--**
    **--**
    **--**
    **--**
    **--**
    **|-**
