****************    ******
*_____*________*    *+M+$*
*_~__~*_____~~~*    *++++*
*_~__~***___~@_******++++*
*_~__~*________P!++++++++*
*_~__~_______@__!++++++++*
*___________~__******++++*
*___________~~~*    ******
*______________*
*___@____@_____*
******__*****__*
     *__*   *__*
     *--*   *__*
    **--**  *__*
    *----*  *__******
    *----*  *_______*
    *----*  *_______*
    *-|--*  ******__*
	******       *__*
                 *__*
                 ****
