*****************************************************
****---------------^^^_____________________~~~~~~~~~*
***----------------^^^^^^^_____@____________________**********
**---------@-------^^^^^^^____________._____~___@_P_!++++++++*
*|---------@-------_._@______..___._________~~......*++++++++*
**--...----@-------^^^^^^^^________.___@___~~~......**+++++++*
***-...------------^^^^^^^^___...________~~~~~......*++++++++*
****...------------^^^________...______~~~~~~~......*++M++++$*
**************************************************************