****************    *******
*_____@__@_____*    *+M+$+*
*~~~________~~~*    *+++++*
*~~~________~~~******+++++*
*______________P!+++++++++*
*______________@_+++++++++*
*^^^__^^^^^^^^^******+++++*
*^^^__^^^^^^^^^*    *******
*__@__@________*
*______________*
*~~~~~~~~__~~~~*
*~~~~~~~~__~~~~*
*______________*
*___@____@_____*
*****----*******
    *----*
    **--**
    **--**
    **--**
    **--**
    **--**
    **--**
    **--**
    **--**
    **|-**
