*****************************************************
****---------------^^^______________________________*
***----------------^^^_________@____________________**********
**---------@-------^^^_______________________~___@_P_!________*
*|---------@-------_._@_____________________~~______**++++++++*
**--...----@-------^^^_________________@___~~~______**++++++++*
***-...------------^^^________...________~~~~~______*+++++++++*
****...------------^^^________...______~~~~~~~______*++M++++$+*
***************************************************************