****************    *******
*______________*    *+M+$+*
*__~~~~_____~~~*    *+++++*
*__~~~~_____~@_******+++++*
*__~~~~________P!+++++++++*
*________________+++++++++*
*___________~@_******+++++*
*___________~~~*    *******
*______________*
*___@____@_____*
******__*****__*
     *__*   *__*
     *--*   *__*
    **--**  *__*
    *----*  *__****** ****
    *----*  *_______* *__*
    *----*  *_______* *__*
    *----*  ******__* *__*
    *----*       *__* *__*
    *----*       *__***__*
    *----*       *_______*
    *----*       *_______*
    **|-**       *********
