*****************************************************
****---------------^^^______________________________*
***----------------^^^______________________________**********
**-----------------^^^_______________________~_____P_!________*
*|-----------------_._______________________~~______**++++++++*
**--...------------^^^_____________________~~~______**++++++++*
***-...------------^^^________...________~~~~~______*+++++++++*
****...------------^^^________...______~~~~~~~______*++M++++$+*
***************************************************************