*****************************************************
****---------------^^^_____________________~~~~~~~~~*
***----------------^^^^^^^__________________________**********
**-----------------^^^^^^^____@_______._____~___@_P_!++++++++*
*|-----------------_.________..___._________~~......*++++++++*
**--...------------^^^^^^^^________._______~~~......**+++++++*
***-...------------^^^^^^^^___...________~~~~~......*++++++++*
****...------------^^^________...______~~~~~~~......*++M++++$*
**************************************************************