*****************************************************
****---------------^^^^____________@________________*
***----------------^^^^^^____@_______________________**********
**-----------------^^^^^_________________..._~_____P_!________*
*|-----------------_.______@_____________...~~______**++++++++*
**--...------------^^^_______________@_____~~~__@___**++++++++*
***-...------------^^^^^^_____...________~~~~~______*+++++++++*
****...------------^^^^^^_____...______~~~~~~~______*++M++++$+*
***************************************************************